####################
#..................#
#..######..........#
#..#....#..........#
#..#....#..####..#.#
#..#....#..#..#..#.#
#..######..#..####.#
#............#.....#
#..##############..#
#..................#
#..................#
####################

