####################
#.................##
#..####...........#
#...........####..#
#.................#
####################

